XXXXXXXXDDDDXXXXXXXX
X.............XXXXXX
X........P......XXXX
X..1.............XXX
X.....BB.....4.....X
X.....BB...........D
X..P.....P......P..D
X....3.......B.....D
X..................X
XXX.............2..X
XXXX.....P.........X
XXXXXX.............X
XXXXXXXXDDDDXXXXXXXX