XXXXXXXXDDDDXXXXXXXX
X.............XXXXXX
X........P......XXXX
X..1.............XXX
X............4.....X
X..................D
X..P.....P......P..D
X....3.............D
X..................X
XXX.............2..X
XXXX.....P.........X
XXXXXX.............X
XXXXXXXXDDDDXXXXXXXX