XXXXXXXXDDDDXXXXXXXX
X...............XXXX
X.1P.....P.........X
X...XXXX...........X
X...XXXX......3....X
D...XXXX...P.......D
D...XXXX...........D
D...........XXXX...D
D.......P...XXXX...D
X....4......XXXX...X
X...........XXXX...X
X.........P.....P2.X
XXXX...............X
XXXXXXXXDDDDXXXXXXXX