XXXXXXXXDDDDXXXXXXXX
X...............XXXX
X.1P.....P.........X
X...XXXX.......3...X
X...XXXX...........X
D...XXXX....P......D
D...XXXXBBB........D
D........BBBXXXX...D
D......P....XXXX...D
X...........XXXX...X
X...4.......XXXX...X
X.........P.....P2.X
XXXX...............X
XXXXXXXXDDDDXXXXXXXX