XXXXXXXXXXXXXXXXXXXX
X......XXXXXX......X
X......XXXXXX......X
X..1...XXXXXX...3..X
X......XXXXXX......X
X..................X
XXXXX.P........XXXXX
XXXXX........P.XXXXX
X..................X
X......XXXXXX......X
X..4...XXXXXX...2..X
X......XXXXXX......X
X......XXXXXX......X
XXXXXXXXXXXXXXXXXXXX