XXXXXXXXXXXXXXXXXXXX
X..................X
X.............2....X
X..................X
X...BBBBBBBBBBBB...X
X.4.B..........B...X
X...B..P...P...B...X
X...B....P.....B...X
X...B..........B.3.X
X...BBBBBBBBBBBB...X
X..................X
X....1.............X
X..................X
XXXXXXXXXXXXXXXXXXXX